█████████████████████
█X                  █
█                   █
█                   █
█                   █
█         T         █
█                   █
█                   █
█                   █
█                   █
█                  P█
█████████████████████