█████████████████████
█         █        X█
█           █ ████ b█
█       ██ ██ █ H████
█ █  ████     █     █
█         R         █
█    ████     █     █
████    ██ █████    █
█ P█           █    █
█  ███████ ███ █    █
█                   █
█████████████████████