█████████████████████
█                  P█
█  E                █
██████   █████████  █
█        █       █  █
█   H    █  X    █  █
█        █       █  █
█      ████████     █
█ E █         █ E   █
█   █     E   █  E  █
█   █         █     █
█████████████████████
