█████████████████████
█              E    █
█                   █
█X           █      █
█  G         █      █
█            █P     █
█S           █      █
█  G         █      █
█            █      █
█                   █
█              E    █
█████████████████████