█████████████████████
█              █E  X█
█  E           █    █
███████   ██████    █
█                   █
█     P             █
███████████   █     █
█    E    █   ███████
█         █   █ E   █
█    ██████         █
█                   █
█████████████████████
