█████████████████████
█      B  E  E      █
█          E        █
█      █████████    █
█           j  █    █
█        E    X█    █
█   i ██████████    █
█     █  E  E  E    █
█  i  █ E           █
█    i█ E      █  E █
█i HH █    P   █ EH █
█████████████████████