█████████████████████
█     █  ██  █ ██   █
█  l                █
██████  █  ██ █     █
█        ██ ████  P █
█  E           █   ██
████         AH █ ███
█  █    █████████ ███
█ X█         E  █ ███
█  █            █   █
█                i  █
█████████████████████