█████████████████████
█                   █
█                 E █
█   ████  █   █     █
█         █   █  X  █
█    ██████ P ███████
█    E        █     █
█    E        █  H  █
█       ███████     █
█                   █
█    E              █
█████████████████████
