█████████████████████
█  E    E          P█
█    E              █
█       █     ███████
█ H     █     █k E  █
██████ff█          j█
█                   █
█l              █████
█    fff█          j█
█    fff█           █
█     i █  X  █  H  █
█████████████████████