█████████████████████
█                  P█
█  E                █
██████   █████████  █
█        █       █  █
█   ██   █  X    █  █
█   █    █       █  █
█   █  ████████     █
█ E █         █ E   █
█   █     E   █  E  █
█   █         █     █
█████████████████████
