█████████████████████
█      f   ffff     █
█      f   ffff     █
█P                 j█
███████         E   █
█ffffff    ffff     █
█    ff    ██████████
█    ██            f█
█    ff           G █
█    ff             █
█            ff    X█
█████████████████████