█████████████████████
█                   █
█                 j █
█   ████  █   █     █
█         █   █  X  █
█    ██████ P ███████
█    E        █     █
█    l        █  H  █
█       ███████     █
█                   █
█    E              █
█████████████████████
