█████████████████████
█                   █
█                 ← █
█   ████  █   █     █
█         █   █  X  █
█    ██████ P ███████
█    E        █     █
█    →        █  C  █
█       ███████     █
█                   █
█    E              █
█████████████████████
█                   █